segment	transcripció	explicació	comentaris
			
# b  			
amb tu i amb mi	ˈam tˈu j ˈam mˈi	emmudiment de b després de m	ok
amb ell	ˈamb ˈɛʎ	sensiblitizació de la b de «amb» davant de vocal	verificar
rumb a l'oest	rˈum ə luˈest	emmudiment de b després de m	ok
Abac	əβˈak	b aproximant entre vocals	ok
quatre bacs	kwˈatɾə βˈaks	b aproximant entre vocals	ok
albarà   	əlβəɾˈa	b aproximant entre líquida o fricativa i vocal	ok
al bar	əl βˈar	b aproximant entre líquida o fricativa i vocal 	ok
esbós	əzβˈos	b aproximant entre líquida o fricativa i vocal 	ok
els boscos	əlz βˈɔskus	b aproximant entre líquida o fricativa i vocal	ok
un tub	un tˈup	b ensordeix a final de paraula	ok
dissabte	disˈaptə	b ensordeix davant de consonant sorda	ok
un tub ample	un tˈup ˈamplə	b ensordeix a final de paraula	ok
calbícia	kəlβˈisiə	b aproximant entre líquida o fricativa i vocal 	ok
calb i espès	kˈalp i əspˈɛs	emudiment de b a final de paraula	ok
població noble	pubbləsiˈo nˈɔbblə	geminació del grup «bl» 	ok
			
# c			
catacrac	kətəkɾˈak	c sona [k]	ok
Cecília	səsˈiliə	c sona s davant de «e» i de «i»	ok
èczema	ˈɛɡzəmə	c sona [g] davant de consonant sonora	ok
soc jo	sˈɔɡ ʒˈɔ	c sona [g] davant de consonant sonora	ok
encara en tinc	əŋkˈaɾə ən tˈiŋ	c després de «n» fa canviar el punt d’articulació de la nasal, i s’emmudeix a final de mot	ok
encès	ənsˈɛs	c desrpés de «n» i seguida de «e» o «i» no fa canviar la nasal	ok
			
# ç			
llaç	ʎˈas	ç sona [s]	ok
llaç estret	ʎˈaz əstɾˈet	ç sona [z] davant de vocal	ok
llaç bonic	ʎˈaz βunˈik	ç sona [z] davant de consonant sonora	ok
			
# d			
dos	dˈɔs	d és d a inici de mot	ok
àcid	ˈasit	d és [t] a final de mot	ok
àcid sulfúric	ˈasit sulfˈuɾik	d és [t] seguida de consonant sorda	ok
àcid aquós	ˈasit əkwˈos	d és [t] a final de paraulaseguida de consonant sorda	ok
àcid vermell	ˈasid bərmˈɛʎ	d és [d] a final de paraulaseguida de consonant sonora	ok
adscrit	ətskɾˈit	d és [t] seguida de consonant sorda	ok
endur	əndˈu	d és d entre nasal i vocal	ok
calda	kˈaldə	d és d entre l i vocal	ok
maragda	məɾˈaɡdə	d és d entre oclusiva i vocal	ok
la diada de demà	lə ðiˈaðə ðə ðəmˈa	d és aproximant entre vocals	ok
esdevenir	əzðəβənˈi	d és aproximant entre fricativa i vocal	ok
es dona	ˈez ðˈɔnə	d és aproximant entre fricativa i vocal	ok
arbust	ərβˈust	d és aproximant entre r i vocal	ok
vidre	bˈiðɾə	d és aproximant entre vocal i r	ok
examimand	əɡzəmimˈan	emmudiment de «d» deprés de «n» en final de mot	ok
			
# f			
fa fred	fˈa fɾˈet	f és f	repassar davant de r
afganès	əvɣənˈɛs	f sona [v] davant de consonant sonora	ok
escalf d’amor	əskˈalv ðəmˈo	f sona [v] davant de consonant sonora	ok
escalf amic	əskˈalv əmˈik	f sona [v] davant de vocal	ok
			
# g			
groc	ɡɾˈɔk	g és [g] a inici de mot	ok
guia	ɡˈiə	gu és [g] davant de i o e, i la u no es pronuncia	ok
preg	pɾˈek	g és [k] a final de mot	ok
diàleg amè	diˈalək əmˈɛ	g és [k] a final de mot	ok
pago	pˈaɣu	g és aproximant entre vocal i a o o	ok
una guia	ˌunə ɣˈiə	gu és aproximant entre vocal i i o e, i la u no es pronuncia	ok
En Roger va a Girona	ən ruʒˈe βˈa ə ʒiɾˈonə	g és [ʒ] davant de i o e	ok
esgarrapa i produeix gas	əzɣərˈapə j pɾuðwˈeʒ ɣˈas	g és aproximant entre fricativa i «a» o «o»	ok
algues i cargols	əlɣˈez i kərɣˈols	g és aproximant entre r o l i a, o, u	ok
aigüera	əjɣwˈeɾə	g és aproximanet entre vocal i ü	ok
anagrama	ənəɣɾˈamə	g és aproximant entre vocal i r + vocal	ok 
raig	rˈatʃ	ig és [tʃ] a final de mot	ok
roig encès	rˈɔdʒ ənsˈɛs	ig és [dʒ] a final de mot seguit de vocal	ok
roig feixuc	rˈɔdʒ fəʃˈuk	ig és [dʒ] a final de mot seguit de sonora	ok
aglomeració		geminació del grup «gl» 	ok
			
# i			
mira	mˈiɾə	i és  [i]	ok
aigua	ˈajɣwə	i és [j] després de vocal	ok
una i mitja	ˌunə j mˈidʒə	i és [j] després de vocal	ok
quincalla	kiŋkˈaʎə	i és [i] després de «gu» i «qu»	ok
əɡɡluməɾəsiˈo	nˈan	i és [i] després de «gü» i «qü»	ok
camió	kəmiˈo	i és [i] abans de vocal	ok
			
# m			
mama	mˈamə	m és [m]	ok
amfiteatre	əɱfitɛˈatɾə	m és [ɱ] davant de f	ok
anem fent	ˈanəɱ fˈen	m és [ɱ] davant de f	ok
			
# n			
nena	nˈenə	n és [n]	ok
en veu	əm bˈew	n és [m] quan va seguida de labial	ok
un bol	um bˈɔl	n és [m] quan va seguida de labial	ok
en pau	əm pˈaw	n és [m] quan va seguida de labial	ok
confecció	kuɱfəksiˈo	n és [ɱ] davant de f	falta
un ferro	uɱ fˈɛru	n és [ɱ] davant de f	falta
ungla	ˈuŋɡlə	n és [ŋ] quan va seguida de velar 	ok
enquesta	əŋkˈestə	n és [ŋ] quan va seguida de velar 	ok
un gat	uŋ ɡˈat	n és [ŋ] quan va seguida de velar 	ok
en compra	əŋ kˈɔmpɾə	n és [ŋ] quan va seguida de velar 	ok
tinc sang	tˈiŋ sˈaŋ	n és [ŋ] quan va seguida de velar  + emmudiment de la velar si és al final de paraula	ok
sang i fetge	sˈaŋk i fˈedʒə	n és [ŋ] quan va seguida de velar + no emmudiment de velar si va seguida de vocal 	ok
			
# p			
a camp obert	ə kˈam uβˈɛɾt	emmudiment de p després de [m] seguit de vocal	ok
un camp cobert	uŋ kˈam kuβˈɛɾt	emmudiment de p després de [m] seguit de consonant	ok
compte	kˈɔmtə	emmudiment de p després de [m] seguit de consonant	ok
comprar	kumpɾˈa	no emmudiment de «p» entre «m» i «r»	ok
Irromp-hi	irˈompi	no emmudiment al final d’imperatiu seguit de «hi» o «ho»	ok
hipnosi	ibnˈozi	sonorització davant de consonant sonora	ok
cap límit	kˈap lˈimit	sonorització davant de consonant sonora	ha de ser aproximant?
			
# q			
Iraq	iɾˈak	q sona [k]	ok
quatre quintos	kwˈatɾə kˈintus	«q» sona [k] quan va seguida de «u» 	ok
Iraq lliure	iɾˈaɡ ʎˈiwɾə	«q» sona [g] a final de paraula seguida de consonant sonora	repassar
			
# s			
sol	sˈɔl	«s» sona [s]	ok
mossa	mˈɔsə	«ss» sona [s]	ok
casa	kˈazə	«s» sona [z] entre vocals	ok
les ones	ləz ˈɔnəs	«s» sona [z] a final de paraula i davant vocal	ok
els uns	əlz ˈuns	«s» sona [z] a final de paraula i davant vocal	ok
els homes	əlz ˈɔməs	«s» sona [z] a final de paraula i davant de «h» + vocal	ok
els gasos esguerrats	əlz ɣəzˈoz əzɣərˈats	«s» sona [z] davant de consonant sonora	ok
anys	ˈaɲʃ	«s» sona [ʃ] després de «ny»	ok
anys i anys	ˈaɲʒ i ˈaɲʃ	«s» sona [ʒ] després de «ny» i abans de vocal	ok
aquests dies	əkˈedz ðˈiəs	la «s» d’ «aquest/s» no es pronuncia	ok
aquest amic	əkˈest əmˈik	la «s» d’ «aquest» es pronuncia quan va seguida de vocal	ok
els xocs	əlʃ ʃˈɔks	«s» sona [ʃ] davant de [ʃ] 	ok
els jocs	əlʒ ʒˈɔks	«s» sona [ʒ] davant de [ʒ] 	ok
			
# t			
atleta	ədlˈetə	sonorització de «t» davant de consonant sonora	ok
comprat millor	kumpɾˈad miʎˈo	sonorització de «t» davant de consonant sonora	ha de ser aproximant?
anant	ənˈan	emmudiment de «t» després de «n»	ok
Anant-hi	ənˈanti	sensiblització de «t» després de «n» seguit de -hi, -ho	ok
vint anys	bˈint ˈaɲʃ	sensiblització de «t» després de «n» seguit de vocal	ok
molt	mˈɔl	emmudiment de «t» desrpés de «l» final de mot	ok
setmana	səmmˈanə	geminació del grup «tm»	ok
cotna	kˈɔnnə	geminació del grup «tn»	ok
espatlla	əspˈaʎʎə	geminació del grup «tl»	ok
			
# u			
una 	ˈunə	«u» és [u]	
veniu	bənˈiw	«u» és [w] després de vocal	
quatre 	kwˈatɾə	«u» és [w] abans de vocal	
cuit	kˈujt	«u» és [u] davant de i	
circuït	sirkuˈit	«u» és [u] davant de ï	
aigüera	əjɣwˈɛɾə	«ü» és [u] abans de vocal	
			
# v			
vell	bˈɛʎ	«v» sona [b]	ok
avi	ˈaβi	«v» és aproximant entre vocals	ok
la vella	lə βˈɛʎə	«v» és aproximant entre vocals	ok
el vell	əl βˈɛʎ	«v» és aproximant entre «l», «r» o fricativa i vocal	ok
			
# x			
taxa	tˈaksə	«x» sona [ks]	ok
exàmen	əɡzˈamən	«x» sona [gz] en paraules començades en vocal, si seguida de vocal o sonora	ok
expresident	ekspɾəziðˈen	«x» sona [ks] en paraules començades en vocal, si seguida de sorda	ok
enxaneta	ənʃənˈetə	«x» sona [ʃ] després de no-vocal	ok
caixa	kˈaʃə	«ix» sona [iʃ] després de no vocal	ok
pixa	pˈiʃə	«ix» sona [ʃ] després de vocal i la «i» no es pronuncia	ok
calaix 	kəlˈaʃ	«ix» sona [ʃ] després de vocal i final de paraula	ok
calaix tancat	kəlˈaʃ təŋkˈat	«ix» sona [ʃ] després de vocal i final de paraula si la següent paraula comença amb consonant sorda	ok
calaix obert	kəlˈaʒ uβˈɛɾt	«ix» sona [ʒ] després de vocal i final de paraula si la següent paraula comença vocal	ok
calaix bonic	kəlˈaʒ βunˈik	«ix» sona [ʒ] després de vocal i final de paraula si la següent paraula comença amb consonant sonora	ok
metxa	mˈetʃə	«tx» sona [tʃ] seguida de vocal	ok
despatx d’advocat	dəspˈadʒ dəbbʊkˈat	«tx» sona [dʒ] a final de paraula seguida de consonant sonora	ok
despatx obert	dəspˈadʒ uβˈɛɾt	«tx» sona [dʒ] a final de paraula seguida de vocal	ok
			
# e			
festa	fˈestə	«e» sona [e]	ok
cel	sˈɛl	«e» sona [ɛ] davant de l	ok
merla	mˈɛrlə	«e» sona [ɛ] davant de r	ok
serp	sˈerp	«e» sona [e] davant de r + m/p/b	mirar què passa amb «erm» i «ferm»
element	ələmˈen	«e» sona [ə] quan és àtona	ok
fonètica	funˈɛtikə	«e» sona [ɛ] 	ok
carrer	kərˈe	«e» sona [e] a la terminació -er	ok
panteó neoclàssic	pənteˈo neoklˈasik	«e» sona [e] davant de [a] (no neutralitza)	ok
teatre real	teˈatɾə reˈal	«e» sona [e] davant de [a] (no neutralitza)	ok
			
# o			
		o sona [o]	
mocador	mukəðˈo	«o» sona [u] quan és àntona	ok
cosa	kˈɔzə	«o» sona [ɔ] quan la síl·laba tònica és la primera	ok
flor	flˈɔ	«o» sona [ɔ] en monosíl·labs	però «moc»
color	kulˈo	«o» sona [o] en les terminacions en -or	ok
cou	kˈɔw	«o» sona [ɔ]  davant de u	ok
